㐔|ZZ亯X乙|
㐣|P庫乙 Z庫乙|
㐮|E六𠀎𧘇 㐮|
㒻|Z冃見|
㝹|Z少免 Z少兔|江東呼兔子曰𩆟。【集韻】𩆟，或作㝹。亦作䨲。今譌从免。㝹从免。
㠭|ZH工工H工工 HZ工工Z工工|
䇫|Z𥫗𦣝 Z𥫗𦣞|
䣺|H酉肙 H酉䏍|右從Z厶⺼?
䨻|ZH雷雷H雷雷 HZ雷雷Z雷雷|
䲜|Z䲆䲆 HZ魚魚Z魚魚|
临|PZ监XO囗丨 临|
乔|Z夭H丿丨 乔|
争|Z𠂊ZX爭 争|
亣|Z亠H丿丨 亣|
亯|ZZ亯X日 E亠口日|!!
介|Z人H丿丨 介|丿丨
佥|Z亼Z兴X 佥|
倝|HH倝X人 HZ十早人|从旦㫃聲
充|Z亠允 Z𠫓儿|
兓|H旡旡 H旡旡|
兹|Z䒑𢆶 兹|
养|ZZ䒑夫H丿丨 养|?
击|ZV扌凵 击|
刼|H去刄 H去刃|
卿|W𠂎V皀卩 O卯V皀|
叀|Z𤰔厶 叀|
参|ZZ厶大彡 E厶大彡|
叕|Z双双 H㕛㕛|
受|ZZ爫冖又 E爫冖又|
呈|Z口王 Z口𡈼|
呉|Z口V夨 呉|?
商|ZZ亠丷冏 商|
啇|ZZ亠丷N冂古 啇|
善|E𦍌䒑口 善|
嘼|Z㽞𠮛 嘼|
囊|ZZ囊XE吅𠀎𧘇 囊|*
囟|OZ丿囗乂 囟|
囱|OZ丿囗夂 囱|
圅|ZマO囗𢆉 圅|
宂|Z宀儿 Z宀几|
宐|E宀夕一 宐 Z宀E一夕一 宐|?
害|E宀丰口 E宀丯口|從宀从口丯聲
尭|Z𠦄兀 尭|?
尽|Z尺⺀|
巨|C匚コ C工コ|片假名コ
幾|QZ 𢆶戈人 U戌𢆶 幾|??
廌|PP鹿XZX焉 廌|****
彘|Z彑W匕矢匕 彘|
徴|NN微X土 W彳Z山𡈼攵|
悁|H忄肙|
懶|H忄賴|
捐|H扌肙|
撍|H扌朁|撍?
暴|ZZ日共氺 E日共氺|
曼|ZZ曰罒又 E曰罒又|从又冒聲
柺|H木另 H木𠮠|
桒|Z𠦄木 桒|?
梁|ZH氵刅木 ZZ梁X木|郎頭
檨|H木羡|
欥|H曰欠|
欴|HV良欠|
残|H歹戋|
沗|Z天氺|
沿|H氵㕣|
浅|H氵戋|
瀞|H氵静|
焉|Z正ZX焉 焉|焉下
無|ZZ無X灬 無|?
燚|H炎炎 ZH火火H火火|
爭|Z爫ZX爭 爭|!!
珊|H王冊 H王册|
瑱|H王真 H王真|
產|Z文P厂生 PZ文厂生|从彥省聲
畚|ZZ厶大田 E厶大田|
疐|EZ十冖田疋 㚄|
瘝|P疒眔|
睊|H目肙|
箆|Z𥫗Z𠔿比 E𥫗𠔿比|
範|Z𥫗H車㔾|
粣|H米册 H米冊|
繅|H糹巢 H糹V巢|
肴|Z乂有 Z乂P𠂇⺼|爻⺼?
脮|H⺼妥 H月妥|
舜|ZZ爫冖舛 E爫冖舛|
荧|ZZ荧X火 荧|
華|Z艹ZX華 華|
藵|E艹保衣|
虜|P虍男 P虍Z毌力|?
蝹|H虫昷 H虫𥁕|
貵|ZZ厶大貝 E厶大貝|
跚|H𧾷册|
鄑|H晋阝|
鄛|H巢阝 HV巢阝|
酁|H毚阝 HZ㲋免阝|? the number of stroke doesn't match
鋗|H金肙|
隙|H阝𡭴|
隲|H阝Z少馬 P陟馬|
鯗|ZZ𦍌八魚 E𦍌八魚|***養頭或作Z𦍌人？
鼍|ZZ㽞一黾 E㽞一黾|
𠀶|L不失 L𣎴失|
𠁠|ZH且且H且且 HZ且且Z且且|
𠄪|Z氶二 Z丞一|
𠈌|H仌仌 Z从从|
𠉈|H亻Z大月 H亻Z大⺼|？
𠉚|H亻Z八仚 H亻E八人山|？
𠉥|H亻𦙌 W亻Z幺⺼乚|
𠉳|W亻𦈢刂 H亻H𦈢刂|
𠍭|W亻咅及 H倍及|
𠎴|H亻L尾布 L𠉜布|OR？
𠐅|H佴宜 W亻耳宜|
𠑌|HH亻丨遺 W亻丨遺|
𠒢|L元兔 H元兔|
𠔻|ZH興興H興興 HZ興興Z興興|
𠖇|E冖日大 Z冖旲|
𠘒|W冫青舟 H凊舟|
𠫬|H厸厸 ZH厶厶H厶厶 H㕕㕕|
𠫭|E厶大小 ZZ厶大小|
𠫵|E厶大㣺 ZZ厶大㣺|
𠫻|E厶大凷 ZZ厶大凷|
𠫿|E厶大更 ZZ厶大更|
𠶴|W口阝市 H口H阝市|
𠷣|H口虽|
𠼫|W口金亍|
𡁀|W口圅欠|
𡈶|ZH囚囚H囚囚|
𡊄|E厶大土|
𡙛|Z兹大|
𡧈|Z宀亐|
𡧏|E宀匕匕 Z它匕|
𡭂|H朿㝵|
𡴛|Z屮毐 Z屮Z土毋|
𡶭|H山刑|
𢁓|Z丆巾|
𢅍|E𥑟大巾 Z𥑟Z大巾|
𢊁|PP鹿XQ勹灬 廌|
𢛔|H忄東|
𢜍|ZH𤣩勿心 J𤣩忽|
𢨳|Z戶戶|
𣁍|ZZ爫冖文 E爫冖文|
𣆫|Z臼日 Z𦥑日|
𣊴|ZZ日共𠦂 E日共𠦂|
𣋍|ZZ曰罒肥 E曰罒肥|
𣐁|ZZ十冖木 E十冖木|
𣐥|Z目木|
𣓑|ZZ十冖果 E十冖果|
𣕦|H木相 H林目|
𣗛|H木格 W林各|
𣗳|W木豆寸 H木H豆寸|
𣗷|E釆大木 Z𢍏木|
𣢧|H㬰欠|
𣣙|HZZ十冖木欠 HE十冖木欠|
𣣿|HZZ士冖台欠 HE十冖台欠|
𣲊|Z卜Q⺄水 QZ卜⺄水|
𣴈|W氵𠤏刂 H氵H𠤏刂|
𣵃|W氵𢆉刂 H氵H𢆉刂|
𣵝|H波卜 W氵皮卜|
𤈚|ZZ爫冖火 E爫冖火|
𤉣|H火甾|
𤎀|Z业羙|
𤕐|ZZ十冖父 E十冖父|
𤛜|W牜姜刂 H𤚖刂|
𤛭|Z牪牪 H𤘧𤘧|
𤜵|H犭开|
𤠔|H犭員|
𤲸|Z兹田 Z茲田|
𤳳|ZH田田H田田 H畕畕|
𤳴|ZH田田H可可 HZ田可Z田可|
𤴒|EH田田H囘鳥H田田 EH田田H囘鳥H田田|
𥞩|H禾并 H禾幷|
𥪧|H立眞 H立真|
𥲀|Z𥫗巢|
𦃙|ZZ日共糸 E日共糸|
𦈨|H缶开|
𦠕|EZ齊X口肉|
𦤼|ZZ士冖至 E士冖至|
𧔭|ZZ丷O西人䖵 ZV酋䖵|
𧙧|H衤幵|
𧥦|H言亐|
𧱌|ZZ爫冖豕 E爫冖豕|
𧲨|H豸开|
𧷷|E㞢囧貝|𧷷本作𧸇，從𡍬貝
𨅊|H𧾷H育攵 W𧾷育攵|
𨊻|H車开|
𨌉|H車肙|
𨞰|W𨙨皀邑 O𨛜皀|
𨟝|W香育阝 HH香育阝 |
𨠒|ZZ厶大酉 E厶大酉|
𨤗|E釆大目 Z𢍏目|
𨤥|E口一里|
𨧗|W金方彡 H金H方彡|
𨰻|Z鍂鍂 HZ金金Z金金|
𨼨|W阝帝己 H阝H帝己|
𨿀|Z臼隹|
𩠒|H九𩠐|
𪊑|P鹿开|
𪍇|H麥隹|
𪙖|ZZ釆大齒 Z𢍏齒|
𪚥|ZH龍龍H龍龍|
